,country,gold,silver,bronze,total
0,Austria,3,5,2,10
1,Canada,0,2,3,5
2,Czechoslovakia,0,1,2,3
3,Federal Republic of Germany,2,4,2,8
4,Finland,4,1,2,7
5,France,1,0,1,2
6,German Democratic Republic (Germany),9,10,6,25
7,Italy,2,1,2,5
8,Japan,0,0,1,1
9,Liechtenstein,0,0,1,1
10,Netherlands,3,2,2,7
11,Norway,0,3,2,5
12,Sweden,4,0,2,6
13,Switzerland,5,5,5,15
14,USSR,11,9,9,29
15,United States of America,2,1,3,6
16,Yugoslavia,0,2,1,3
