,country,gold,silver,bronze,total
0,Austria,3,4,4,11
1,Canada,1,1,1,3
2,Czechoslovakia,1,2,1,4
3,Federal Republic of Germany,2,2,3,7
4,Finland,1,2,2,5
5,France,4,3,2,9
6,German Democratic Republic (Germany),1,2,2,5
7,Italy,4,0,0,4
8,Netherlands,3,3,3,9
9,Norway,6,6,2,14
10,Romania,0,0,1,1
11,Sweden,3,2,3,8
12,Switzerland,0,2,4,6
13,USSR,5,5,3,13
14,United States of America,1,5,1,7
