,country,gold,silver,bronze,total
0,Austria,2,2,2,6
1,Canada,1,1,1,3
2,Czechoslovakia,0,1,0,1
3,Federal Republic of Germany,2,5,3,10
4,Finland,2,4,1,7
5,France,0,0,1,1
6,German Democratic Republic (Germany),7,5,7,19
7,Great Britain,1,0,0,1
8,Italy,1,2,1,4
9,Liechtenstein,0,0,2,2
10,Netherlands,1,2,3,6
11,Norway,3,3,1,7
12,Sweden,0,0,2,2
13,Switzerland,1,3,1,5
14,USSR,13,6,8,27
15,United States of America,3,3,4,10
