,country,gold,silver,bronze,total
0,Austria,3,2,2,7
1,Bulgaria,0,0,1,1
2,Canada,0,1,1,2
3,Czechoslovakia,0,0,1,1
4,Federal Republic of Germany,0,2,3,5
5,Finland,1,5,3,9
6,France,0,0,1,1
7,German Democratic Republic (Germany),9,7,7,23
8,Great Britain,1,0,0,1
9,Hungary,0,1,0,1
10,Italy,0,2,0,2
11,Japan,0,1,0,1
12,Liechtenstein,2,2,0,4
13,Netherlands,1,2,1,4
14,Norway,1,3,6,10
15,Sweden,3,0,1,4
16,Switzerland,1,1,3,5
17,USSR,10,6,6,22
18,United States of America,6,4,2,12
