,country,gold,silver,bronze,total
0,Australia,1,2,2,5
1,Austria,0,0,1,1
2,Belgium,1,5,2,8
3,Canada,3,3,10,16
4,Czechia,0,0,2,2
5,Denmark,0,2,3,5
6,Finland,1,1,3,5
7,France,5,5,9,19
8,Germany,3,5,5,13
9,Great Britain,56,51,39,146
10,Greece,0,3,1,4
11,Hungary,3,4,2,9
12,Italy,2,2,0,4
13,Netherlands,0,0,2,2
14,Norway,2,3,3,8
15,Russian Federation,1,2,0,3
16,South Africa,1,1,0,2
17,Sweden,8,6,11,25
18,United States of America,23,12,12,47
